10 10
0 0
7 9
12 5 6 13 6 12 5 6 12 6
8 6 10 12 3 11 12 3 10 10
10 10 10 10 12 5 3 13 3 10
10 10 9 3 8 5 5 5 5 2
10 9 4 5 3 12 5 6 12 3
8 6 9 6 12 1 6 10 9 6
10 9 5 0 2 12 3 9 4 3
10 12 6 10 11 9 5 7 10 12
10 11 10 9 5 5 5 6 10 10
9 5 3 13 5 5 5 3 9 3